0,3,3,0,3,3,3,3,3,3,3,3,3,3,3,3,3,3,3,3,3,3,3,1,1,3,3,3,3,3,3,1,1,3,3,3,3,3,0,0,0,0,0,0,0,0,0,0,0,0,0,0,0,3,3,3,3,3,3,3,3,3,3,3,3,3,3,3,3,3,3,3,3,3,3,3,3,3,3,3,3,3,3,3,3,3,3,3,3,3
0,3,3,0,3,3,3,3,3,3,3,3,3,3,3,3,3,3,3,3,3,3,3,1,1,3,3,3,3,3,3,1,1,3,3,3,3,3,6,6,6,6,6,6,6,6,6,6,6,6,6,0,0,3,3,3,3,3,3,3,3,3,3,3,3,3,3,3,3,3,3,3,3,3,3,3,3,3,3,3,3,3,3,3,3,3,3,3,3,3
0,3,3,0,3,3,3,3,3,3,3,3,3,3,3,3,3,3,3,3,3,3,3,1,1,3,3,3,3,3,3,1,1,3,3,3,3,3,6,6,6,6,6,6,6,6,6,6,6,6,6,0,0,3,3,3,3,3,3,3,3,3,3,3,3,3,3,3,3,3,3,3,3,3,3,3,3,3,3,3,3,3,3,3,3,3,3,3,3,3
0,3,3,0,3,3,3,3,3,3,3,3,3,3,5,5,5,5,3,3,5,5,5,5,5,5,5,5,5,5,5,5,5,5,5,5,3,3,0,0,0,0,0,0,0,0,0,0,0,6,6,0,0,3,3,3,3,3,3,3,3,3,3,3,3,3,3,3,3,3,3,3,3,3,3,3,3,3,3,3,3,3,3,3,3,3,3,3,3,3
0,3,3,0,3,3,3,3,3,3,3,3,3,3,3,1,1,3,3,3,3,3,3,3,3,3,3,3,3,3,3,3,3,3,3,3,3,3,0,0,6,6,6,6,6,6,6,6,6,6,6,0,0,3,3,3,3,3,3,3,3,3,3,3,3,3,3,3,3,3,3,3,3,3,3,3,3,3,3,3,3,3,3,3,3,3,3,3,3,3
0,3,3,0,3,3,3,3,3,5,5,5,5,3,3,1,1,3,3,3,3,3,3,3,3,3,3,3,3,3,3,3,3,3,3,3,3,3,0,0,6,6,6,6,6,6,6,6,6,6,6,0,0,3,3,3,3,3,3,3,3,3,3,3,3,3,3,3,3,3,3,3,3,3,3,3,3,3,3,3,3,3,3,3,3,3,3,3,3,3
0,3,3,0,3,3,3,3,3,3,1,1,3,3,3,1,1,3,3,3,3,3,3,3,3,3,3,3,3,3,3,3,3,3,3,3,3,3,0,0,6,6,0,0,0,0,0,0,0,0,0,0,0,3,3,3,3,3,3,3,3,3,3,3,3,3,3,3,3,3,3,3,3,3,3,3,3,3,3,3,3,3,3,3,3,3,3,3,3,3
0,3,3,0,3,3,3,3,3,3,1,1,3,3,5,5,5,5,3,3,3,3,3,3,3,3,3,3,3,3,3,3,3,3,3,3,3,3,0,0,6,6,6,6,6,6,6,6,6,6,6,0,0,3,3,3,3,3,3,3,3,3,3,3,3,3,3,3,3,3,3,3,3,3,3,3,3,3,3,3,3,3,3,3,3,3,3,3,3,3
0,3,3,0,3,3,3,3,3,3,1,1,3,3,3,1,1,3,3,3,3,3,3,3,3,3,3,3,3,3,3,3,3,3,3,3,3,3,0,0,6,6,6,6,6,6,6,6,6,6,6,0,0,3,3,3,3,3,3,3,3,3,3,3,3,3,3,3,3,3,3,3,3,3,3,3,3,3,3,3,3,3,3,3,3,3,3,3,3,3
0,3,3,0,3,3,3,3,3,3,1,1,3,3,3,1,1,3,3,5,5,5,5,3,3,3,3,3,3,3,3,3,3,3,3,3,3,3,0,0,0,0,0,0,0,0,0,0,0,6,6,0,0,3,3,3,3,3,3,3,3,3,3,3,3,3,3,3,3,3,3,3,3,3,3,3,3,3,3,3,3,3,3,3,3,3,3,3,3,3
0,3,3,0,3,3,3,3,3,3,1,1,3,3,3,1,1,3,3,3,1,1,3,3,3,3,3,3,3,3,3,3,3,3,3,3,3,3,0,0,6,6,6,6,6,6,6,6,6,6,6,0,0,3,3,3,3,3,3,3,3,3,3,3,3,3,3,3,3,3,3,3,3,3,3,3,3,3,3,3,3,3,3,3,3,3,3,0,0,0
0,3,3,0,3,3,3,3,3,3,1,1,3,3,3,1,1,3,3,3,1,1,3,3,5,5,5,5,3,3,3,3,3,3,3,3,3,3,0,0,6,6,6,6,6,6,6,6,6,6,6,0,0,3,3,3,3,3,3,3,3,3,3,3,3,3,3,3,3,3,3,3,3,3,3,3,3,3,3,3,3,3,3,3,3,3,0,0,3,3
0,3,3,0,3,3,3,3,3,3,1,1,3,3,3,1,1,3,3,3,1,1,3,3,3,0,0,3,3,3,3,3,3,3,3,3,3,3,0,0,6,6,0,0,0,0,0,0,0,0,0,0,0,3,3,3,3,3,3,3,3,3,3,3,3,3,3,3,3,3,3,3,3,3,3,3,3,3,3,3,3,3,3,3,3,0,0,0,3,3
0,3,3,0,3,3,3,3,3,3,1,1,3,3,3,1,1,3,3,5,5,5,5,3,3,0,0,3,3,3,3,3,3,3,3,3,3,3,0,0,6,6,6,6,6,6,6,6,6,6,6,0,0,3,3,3,3,3,3,3,3,3,3,3,3,3,3,3,3,3,3,3,3,3,3,3,3,3,3,3,3,3,3,3,0,0,0,0,3,3
0,3,3,0,3,3,3,3,3,3,1,1,3,3,3,1,1,3,3,3,0,0,3,3,3,0,0,3,3,3,3,3,3,3,3,3,3,3,0,0,6,6,6,6,6,6,6,6,6,6,6,0,0,3,3,3,3,3,3,3,3,3,3,3,3,3,3,3,3,3,3,3,3,3,3,3,3,3,3,3,3,3,3,0,0,0,0,0,3,3
0,3,3,0,3,3,3,3,3,3,1,1,3,3,5,5,5,5,3,3,0,0,3,3,3,0,0,3,3,3,3,3,3,3,3,3,3,3,0,0,0,0,0,0,0,0,0,0,0,6,6,0,0,3,3,3,3,3,3,3,3,3,3,3,3,3,3,3,3,3,3,3,3,3,3,3,3,3,3,3,3,3,0,0,0,0,0,0,3,3
0,3,3,0,3,3,3,3,3,3,1,1,3,3,3,0,0,3,3,3,0,0,3,3,3,0,0,3,3,3,3,3,3,3,3,3,3,3,0,0,0,0,0,0,0,0,0,0,0,6,6,0,0,3,3,3,3,3,3,3,3,3,3,3,3,3,3,3,3,3,3,3,3,0,3,3,3,3,3,3,3,0,0,0,0,0,0,0,3,3
0,3,3,3,3,3,3,3,3,3,0,0,0,3,3,0,0,3,3,3,0,0,3,3,3,0,0,3,3,3,3,3,3,3,3,3,3,3,0,0,0,0,0,0,0,0,0,0,0,6,6,6,6,3,3,3,3,3,3,3,0,3,3,3,3,3,3,0,3,3,3,3,0,0,0,3,3,3,3,3,0,0,0,0,0,0,0,0,3,3
0,3,3,3,3,3,3,3,3,0,0,0,0,3,3,0,0,3,3,3,0,0,3,3,3,0,0,3,3,3,3,3,3,3,3,3,3,3,0,0,0,0,0,0,0,0,0,0,0,6,6,6,6,3,3,3,3,3,3,0,0,0,3,3,3,3,0,0,0,3,3,0,0,0,0,0,3,3,3,0,0,0,0,0,0,0,0,0,3,3
0,0,0,0,0,0,0,0,0,0,0,0,0,0,0,0,0,0,0,0,0,0,0,0,0,0,0,0,0,0,0,0,0,0,0,0,0,0,0,0,0,0,0,0,0,0,0,0,0,0,0,0,0,0,0,0,0,0,0,0,0,0,0,0,0,0,0,0,0,0,0,0,0,0,0,0,0,0,0,0,0,0,0,0,0,0,0,0,0,0
